8 8 8 8 8 8 8 8 8 8 8 8 8 8 8 8 8 8 8 8 8 8 8 8 8 8 8 8 8 8 8 8 8 8 8 8 8 8 8 8 8 8 8 8 8 8 8 8 8 8
8 8 8 8 8 8 8 8 8 8 8 8 8 8 8 8 8 8 8 8 8 8 8 8 8 8 8 8 8 8 8 8 8 8 8 8 8 8 8 8 8 8 8 8 8 8 8 8 8 8
8 8 8 8 8 8 8 8 8 8 8 8 8 8 8 8 8 8 8 8 8 8 8 8 8 8 8 8 8 8 8 8 8 8 8 8 8 8 8 8 8 8 8 8 8 8 8 8 8 8
8 8 8 8 8 8 8 8 8 8 8 8 8 8 8 8 8 8 8 8 8 8 8 8 8 8 8 8 8 8 8 8 8 8 8 8 8 8 8 8 8 8 8 8 8 8 8 8 8 8
8 8 8 8 8 8 8 8 8 8 8 8 8 8 8 8 8 8 8 8 8 8 8 8 8 8 8 8 8 8 8 8 8 8 8 8 8 8 8 8 8 8 8 8 8 8 8 8 8 8
8 8 8 8 8 8 8 8 8 8 8 8 8 8 8 8 8 8 8 8 8 8 8 8 8 8 8 8 8 8 8 8 8 8 8 8 8 8 8 8 8 8 8 8 8 8 8 8 8 8
8 8 8 8 8 8 8 8 8 8 8 8 8 8 8 8 8 8 8 8 8 8 8 8 8 8 8 8 8 8 8 8 8 8 8 8 8 8 8 8 8 8 8 8 8 8 8 8 8 8
8 8 8 8 8 8 8 8 8 8 8 8 8 8 8 8 8 8 8 8 8 8 8 8 8 8 8 8 8 8 8 8 8 8 8 8 8 8 8 8 8 8 8 8 8 8 8 8 8 8
8 8 8 8 8 8 8 8 8 73 73 73 73 73 73 73 73 73 73 73 73 73 73 73 73 73 73 73 73 73 73 73 73 73 73 73 73 73 8 8 8 8 8 8 8 8 8 8 8 8
8 8 8 8 8 8 8 8 8 73 1 1 1 1 1 1 1 1 1 1 1 1 1 1 1 1 1 1 1 1 1 1 1 1 1 1 1 1 1 1 73 8 8 8 8 8 8 8 8 8 
8 8 8 8 8 8 8 8 8 73 1 0 0 0 0 0 0 0 0 0 0 0 0 1 1 1 0 0 0 0 0 0 0 0 0 0 0 0 0 1 73 8 8 8 8 8 8 8 8 8
8 8 8 8 8 8 8 8 8 73 1 0 0 0 0 0 0 0 0 0 0 0 0 1 1 1 0 0 0 0 0 0 0 0 0 0 0 0 0 1 73 8 8 8 8 8 8 8 8 8
8 8 8 8 8 8 8 8 8 73 1 0 0 0 0 0 0 0 0 0 0 0 0 1 1 1 0 0 0 0 0 0 0 0 0 0 0 0 0 1 73 8 8 8 8 8 8 8 8 8
8 8 8 8 8 8 8 8 8 73 1 0 0 0 0 0 0 0 0 0 0 0 0 1 1 1 0 0 0 0 0 0 0 0 12 12 0 0 0 1 73 8 8 8 8 8 8 8 8 8
8 8 8 8 8 8 8 8 8 73 1 0 0 0 0 0 0 0 0 0 0 0 0 1 1 1 0 0 0 0 0 0 0 11 28 29 9 0 0 1 73 8 8 8 8 8 8 8 8 8
8 8 8 8 8 8 8 8 8 73 1 0 0 0 0 0 0 0 0 0 0 0 0 1 1 1 0 0 0 0 0 0 0 11 30 31 9 0 0 1 73 8 8 8 8 8 8 8 8 8
8 8 8 8 8 8 8 8 8 73 1 0 0 0 0 0 0 0 0 0 0 0 0 1 1 1 0 0 0 0 0 0 0 0 10 10 0 0 0 1 73 8 8 8 8 8 8 8 8 8
8 8 8 8 8 8 8 8 8 73 1 0 0 0 0 0 0 0 0 0 0 0 0 1 1 1 0 0 0 0 0 0 0 0 0 0 0 0 0 1 73 8 8 8 8 8 8 8 8 8
8 8 8 8 8 8 8 8 8 73 1 0 0 0 0 0 0 0 0 65 0 76 0 1 75 1 0 77 0 78 0 0 0 0 0 0 0 0 0 1 73 8 8 8 8 8 8 8 8 8
8 8 8 8 8 8 8 8 8 73 1 0 0 0 0 0 0 0 0 0 0 0 0 1 1 1 0 0 0 0 36 0 36 0 36 0 36 0 0 1 73 8 8 8 8 8 8 8 8 8
8 8 8 8 8 8 8 8 8 73 1 0 0 0 0 0 0 0 0 0 0 0 0 1 1 1 0 0 0 0 0 0 0 0 0 0 0 0 0 1 73 8 8 8 8 8 8 8 8 8
8 8 8 8 8 8 8 8 8 73 1 0 0 0 0 0 0 27 25 26 0 1 1 1 1 1 1 1 0 0 2 0 2 0 2 0 2 0 0 1 73 8 8 8 8 8 8 8 8 8
8 8 8 8 8 8 8 8 8 73 1 0 0 0 0 0 0 0 0 0 0 1 19 18 18 18 20 1 0 0 0 0 0 0 0 0 0 0 0 1 73 8 8 8 8 8 8 8 8 8
8 8 8 8 8 8 8 8 8 73 1 1 1 1 1 1 1 1 1 1 1 1 17 8 8 8 33 1 1 1 1 1 1 1 1 1 1 1 1 1 73 8 8 8 8 8 8 8 8 8 8
8 8 8 8 8 8 8 8 8 73 1 1 1 1 1 1 1 1 1 1 1 1 17 8 74 8 33 1 1 1 1 1 1 1 1 1 1 1 1 1 73 8 8 8 8 8 8 8 8 8
8 8 8 8 8 8 8 8 8 73 1 1 1 1 1 1 1 1 1 1 1 1 17 8 8 8 33 1 1 1 1 1 1 1 1 1 1 1 1 1 73 8 8 8 8 8 8 8 8 8
8 8 8 8 8 8 8 8 8 73 1 0 0 0 0 0 0 0 0 0 0 1 21 34 34 34 22 1 0 0 0 0 0 0 0 0 0 0 0 1 73 8 8 8 8 8 8 8 8 8
8 8 8 8 8 8 8 8 8 73 1 0 0 36 0 36 0 36 0 36 0 1 1 1 1 1 1 1 0 0 0 0 0 0 0 0 0 0 0 1 73 8 8 8 8 8 8 8 8 8
8 8 8 8 8 8 8 8 8 73 1 0 0 0 0 0 0 0 0 0 0 0 0 1 1 1 0 0 0 12 12 0 0 0 12 12 0 0 0 1 73 8 8 8 8 8 8 8 8 8
8 8 8 8 8 8 8 8 8 73 1 0 0 2 0 2 0 2 0 2 0 0 0 1 1 1 0 0 11 28 29 9 0 11 28 29 9 0 0 1 73 8 8 8 8 8 8 8 8 8
8 8 8 8 8 8 8 8 8 73 1 0 0 0 0 0 0 0 0 0 0 0 0 1 1 1 0 0 11 30 31 9 0 11 30 31 9 0 0 1 73 8 8 8 8 8 8 8 8 8
8 8 8 8 8 8 8 8 8 73 1 0 0 0 0 0 0 0 0 0 0 0 0 1 1 1 0 0 0 10 10 0 0 0 10 10 0 0 0 1 73 8 8 8 8 8 8 8 8 8
8 8 8 8 8 8 8 8 8 73 1 0 0 0 0 0 0 0 0 0 0 0 0 1 1 1 0 0 0 0 0 0 0 0 0 0 0 0 0 1 73 8 8 8 8 8 8 8 8 8
8 8 8 8 8 8 8 8 8 73 1 0 0 0 0 0 0 0 0 0 0 0 0 1 1 1 0 0 0 0 0 0 0 0 0 0 0 0 0 1 73 8 8 8 8 8 8 8 8 8
8 8 8 8 8 8 8 8 8 73 1 24 24 24 24 24 24 0 0 0 0 0 0 1 1 1 0 0 0 0 0 0 0 0 0 0 0 0 0 1 73 8 8 8 8 8 8 8 8 8 8
8 8 8 8 8 8 8 8 8 73 1 3 3 3 3 3 24 0 0 0 0 0 0 1 1 1 0 0 0 12 12 0 0 0 12 12 0 0 0 1 73 8 8 8 8 8 8 8 8 8
8 8 8 8 8 8 8 8 8 73 1 3 3 3 3 3 24 0 0 0 0 0 0 1 1 1 0 0 11 28 29 9 0 11 28 29 9 0 0 1 73 8 8 8 8 8 8 8 8 8
8 8 8 8 8 8 8 8 8 73 1 3 3 3 3 3 24 0 0 0 0 0 0 1 1 1 0 0 11 30 31 9 0 11 30 31 9 0 0 1 73 8 8 8 8 8 8 8 8 8
8 8 8 8 8 8 8 8 8 73 1 3 3 3 3 3 24 0 0 0 0 0 0 1 1 1 0 0 0 10 10 0 0 0 10 10 0 0 0 1 73 8 8 8 8 8 8 8 8 8
8 8 8 8 8 8 8 8 8 73 1 3 3 3 3 3 24 0 0 0 0 0 0 1 1 1 0 0 0 0 0 0 0 0 0 0 0 0 0 1 73 8 8 8 8 8 8 8 8 8
8 8 8 8 8 8 8 8 8 73 1 1 1 1 1 1 1 1 1 1 1 1 1 1 1 1 1 1 1 1 1 1 1 1 1 1 1 1 1 1 73 8 8 8 8 8 8 8 8 8
8 8 8 8 8 8 8 8 8 73 73 73 73 73 73 73 73 73 73 73 73 73 73 73 73 73 73 73 73 73 73 73 8 8 8 8 8 8 8 8 8 8 8 8 8 8 8 8 8 8
8 8 8 8 8 8 8 8 8 8 8 8 8 8 8 8 8 8 8 8 8 8 8 8 8 8 8 8 8 8 8 8 8 8 8 8 8 8 8 8 8 8 8 8 8 8 8 8 8 8
8 8 8 8 8 8 8 8 8 8 8 8 8 8 8 8 8 8 8 8 8 8 8 8 8 8 8 8 8 8 8 8 8 8 8 8 8 8 8 8 8 8 8 8 8 8 8 8 8 8
8 8 8 8 8 8 8 8 8 8 8 8 8 8 8 8 8 8 8 8 8 8 8 8 8 8 8 8 8 8 8 8 8 8 8 8 8 8 8 8 8 8 8 8 8 8 8 8 8 8
8 8 8 8 8 8 8 8 8 8 8 8 8 8 8 8 8 8 8 8 8 8 8 8 8 8 8 8 8 8 8 8 8 8 8 8 8 8 8 8 8 8 8 8 8 8 8 8 8 8
8 8 8 8 8 8 8 8 8 8 8 8 8 8 8 8 8 8 8 8 8 8 8 8 8 8 8 8 8 8 8 8 8 8 8 8 8 8 8 8 8 8 8 8 8 8 8 8 8 8
8 8 8 8 8 8 8 8 8 8 8 8 8 8 8 8 8 8 8 8 8 8 8 8 8 8 8 8 8 8 8 8 8 8 8 8 8 8 8 8 8 8 8 8 8 8 8 8 8 8
8 8 8 8 8 8 8 8 8 8 8 8 8 8 8 8 8 8 8 8 8 8 8 8 8 8 8 8 8 8 8 8 8 8 8 8 8 8 8 8 8 8 8 8 8 8 8 8 8 8
8 8 8 8 8 8 8 8 8 8 8 8 8 8 8 8 8 8 8 8 8 8 8 8 8 8 8 8 8 8 8 8 8 8 8 8 8 8 8 8 8 8 8 8 8 8 8 8 8 8