42 42 42 42 42 42 42 42 42 42 42 42 42 42 42 42 42 42 42 42 42 42 42 42 42 42 42 42 42 42 42 42 42 42 42 42 42 42 42 42 42 42 42 42 42 42 42 42 42 42
42 42 42 42 42 42 42 42 42 42 42 42 42 42 42 42 42 42 42 42 42 42 42 42 42 42 42 42 42 42 42 42 42 42 42 42 42 42 42 42 42 42 42 42 42 42 42 42 42 42
42 42 42 42 42 42 42 42 42 42 42 42 42 42 42 42 42 42 42 42 42 42 42 42 42 42 42 42 42 42 42 42 42 42 42 42 42 42 42 42 42 42 42 42 42 42 42 42 42 42
42 42 42 42 42 42 42 42 42 42 42 42 42 42 42 42 42 42 42 42 42 42 42 42 42 42 42 42 42 42 42 42 42 42 42 42 42 42 42 42 42 42 42 42 42 42 42 42 42 42
42 42 42 42 42 42 42 42 42 42 42 42 42 42 42 42 42 42 42 42 42 42 42 42 42 42 42 42 42 42 42 42 42 42 42 42 42 42 42 42 42 42 42 42 42 42 42 42 42 42
42 42 42 42 42 42 42 42 42 42 42 42 42 42 42 42 42 42 42 42 42 42 42 42 42 42 42 42 42 42 42 42 42 42 42 42 42 42 42 42 42 42 42 42 42 42 42 42 42 42
42 42 42 42 42 42 42 42 42 42 42 42 42 42 42 42 42 42 42 42 42 42 42 42 42 42 42 42 42 42 42 42 42 42 42 42 42 42 42 42 42 42 42 42 42 42 42 42 42 42
42 42 42 42 42 42 42 42 42 42 42 42 42 42 42 42 42 42 42 42 42 42 42 42 42 42 42 42 42 42 42 42 42 42 42 42 42 42 42 42 42 42 42 42 42 42 42 42 42 42
42 42 42 42 42 42 42 42 42 42 42 42 42 42 42 42 42 42 42 42 42 42 42 42 42 42 42 42 42 42 42 42 42 42 42 42 42 42 42 42 42 42 42 42 42 42 42 42 42 42
42 42 42 42 42 42 42 42 42 42 42 42 42 42 42 42 42 42 42 42 42 42 42 42 42 42 42 42 42 42 42 42 42 42 42 42 42 42 42 42 42 42 42 42 42 42 42 42 42 42
42 42 42 42 42 42 42 42 42 42 42 42 42 42 42 42 42 42 42 42 42 42 42 42 42 42 42 42 42 42 42 42 42 42 42 42 42 42 42 42 42 42 42 42 42 42 42 42 42 42
42 42 42 42 42 42 42 42 42 42 42 42 42 42 42 42 42 42 42 42 42 42 42 42 42 42 42 42 42 42 42 42 42 42 42 42 42 42 42 42 42 42 42 42 42 42 42 42 42 42
42 42 42 42 42 42 42 42 42 42 42 42 42 42 42 42 42 42 42 42 42 42 42 42 42 42 42 42 42 42 42 42 42 42 42 42 42 42 42 42 42 42 42 42 42 42 42 42 42 42
42 42 42 42 42 42 42 42 42 42 42 42 42 42 42 42 42 42 42 42 42 42 42 42 42 42 42 42 42 42 42 42 42 42 42 42 42 42 42 42 42 42 42 42 42 42 42 42 42 42
42 42 42 42 42 42 42 42 42 42 42 42 42 42 42 42 42 42 42 42 42 42 42 42 42 42 42 42 42 42 42 42 42 42 42 42 42 42 42 42 42 42 42 42 42 42 42 42 42 42
42 42 42 42 42 42 42 42 42 42 66 66 66 66 66 66 66 66 66 66 66 66 66 66 66 66 66 66 66 66 66 66 66 66 66 66 66 66 66 68 42 42 42 42 42 42 42 42 42 42
42 42 42 42 42 42 42 42 42 42 67 72 72 72 72 72 72 72 72 72 72 72 72 72 72 72 72 72 72 72 72 72 72 72 72 72 72 72 72 68 42 42 42 42 42 42 42 42 42 42
42 42 42 42 42 42 42 42 42 42 67 72 72 72 72 72 72 72 72 72 72 72 72 72 72 72 72 72 72 72 72 72 72 72 72 72 72 72 72 68 42 42 42 42 42 42 42 42 42 42
42 42 42 42 42 42 42 42 42 42 67 72 72 72 72 72 72 72 72 72 72 72 72 70 71 71 72 72 72 72 72 72 72 72 72 72 72 72 72 68 42 42 42 42 42 42 42 42 42 42
42 42 42 42 42 42 42 42 42 42 67 72 72 72 72 4 72 72 4 72 72 72 72 72 72 72 72 72 72 72 4 72 72 4 72 72 72 72 72 68 42 42 42 42 42 42 42 42 42 42
42 42 42 42 42 42 42 42 42 42 67 72 72 72 4 5 4 4 5 4 72 72 72 72 72 72 72 72 72 4 5 4 4 5 4 72 72 72 72 68 42 42 42 42 42 42 42 42 42 42
42 42 42 42 42 42 42 42 42 42 67 72 72 72 72 4 72 72 4 72 72 72 72 72 72 72 72 72 72 72 4 72 72 4 72 72 72 72 72 68 42 42 42 42 42 42 42 42 42 42
42 42 42 42 42 42 42 42 42 42 67 72 72 72 72 72 72 72 72 72 72 72 72 72 72 72 72 72 72 72 72 72 72 72 72 72 72 72 72 68 42 42 42 42 42 42 42 42 42 42
42 42 42 42 42 42 42 42 42 42 67 72 72 72 4 4 4 4 4 4 4 72 72 72 72 72 72 72 4 4 4 4 4 4 4 72 72 72 72 68 42 42 42 42 42 42 42 42 42 42
42 42 42 42 42 42 42 42 42 42 67 72 72 72 64 64 64 64 64 64 64 72 72 72 72 72 72 72 64 64 64 64 64 64 64 72 72 72 72 68 42 42 42 42 42 42 42 42 42 42
42 42 42 42 42 42 42 42 42 42 67 72 72 72 10 10 10 10 10 10 10 72 72 72 72 72 72 72 10 10 10 10 10 10 10 72 72 72 72 68 42 42 42 42 42 42 42 42 42 42
42 42 42 42 42 42 42 42 42 42 67 72 72 72 4 4 4 4 4 4 4 72 72 72 72 72 72 72 4 4 4 4 4 4 4 72 72 72 72 68 42 42 42 42 42 42 42 42 42 42
42 42 42 42 42 42 42 42 42 42 67 72 72 72 72 72 72 72 72 72 72 72 72 72 72 72 72 72 72 72 72 72 72 72 72 72 72 72 72 68 42 42 42 42 42 42 42 42 42 42
42 42 42 42 42 42 42 42 42 42 67 72 72 72 72 72 72 72 72 72 72 72 72 72 72 72 72 72 72 72 72 72 72 72 72 72 72 72 72 68 42 42 42 42 42 42 42 42 42 42
42 42 42 42 42 42 42 42 42 42 67 72 72 72 4 4 4 4 4 4 4 72 72 72 72 72 72 72 4 4 4 4 4 4 4 72 72 72 72 68 42 42 42 42 42 42 42 42 42 42
42 42 42 42 42 42 42 42 42 42 67 72 72 72 64 64 64 64 64 64 64 72 72 72 72 72 72 72 64 64 64 64 64 64 64 72 72 72 72 68 42 42 42 42 42 42 42 42 42 42
42 42 42 42 42 42 42 42 42 42 67 72 72 72 10 10 10 10 10 10 10 72 72 72 72 72 72 72 10 10 10 10 10 10 10 72 72 72 72 68 42 42 42 42 42 42 42 42 42 42
42 42 42 42 42 42 42 42 42 42 67 72 72 72 4 4 4 4 4 4 4 72 72 72 72 72 72 72 4 4 4 4 4 4 4 72 72 72 72 68 42 42 42 42 42 42 42 42 42 42
42 42 42 42 42 42 42 42 42 42 67 72 72 72 72 72 72 72 72 72 72 72 72 72 72 72 72 72 72 72 72 72 72 72 72 72 72 72 72 68 42 42 42 42 42 42 42 42 42 42
42 42 42 42 42 42 42 42 42 42 67 72 72 72 72 72 72 72 72 72 72 72 72 72 72 72 72 72 72 72 72 72 72 72 72 72 72 72 72 68 42 42 42 42 42 42 42 42 42 42
42 42 42 42 42 42 42 42 42 42 67 69 69 69 69 69 69 69 69 69 69 69 69 69 65 69 69 69 69 69 69 69 69 69 69 69 69 69 69 69 42 42 42 42 42 42 42 42 42 42 42 42 42 42 42 42 42 42 42
42 42 42 42 42 42 42 42 42 42 42 42 42 42 42 42 42 42 42 42 42 42 42 42 42 42 42 42 42 42 42 42 42 42 42 42 42 42 42 42 42 42 42 42 42 42 42 42 42 42
42 42 42 42 42 42 42 42 42 42 42 42 42 42 42 42 42 42 42 42 42 42 42 42 42 42 42 42 42 42 42 42 42 42 42 42 42 42 42 42 42 42 42 42 42 42 42 42 42 42
42 42 42 42 42 42 42 42 42 42 42 42 42 42 42 42 42 42 42 42 42 42 42 42 42 42 42 42 42 42 42 42 42 42 42 42 42 42 42 42 42 42 42 42 42 42 42 42 42 42
42 42 42 42 42 42 42 42 42 42 42 42 42 42 42 42 42 42 42 42 42 42 42 42 42 42 42 42 42 42 42 42 42 42 42 42 42 42 42 42 42 42 42 42 42 42 42 42 42 42
42 42 42 42 42 42 42 42 42 42 42 42 42 42 42 42 42 42 42 42 42 42 42 42 42 42 42 42 42 42 42 42 42 42 42 42 42 42 42 42 42 42 42 42 42 42 42 42 42 42
42 42 42 42 42 42 42 42 42 42 42 42 42 42 42 42 42 42 42 42 42 42 42 42 42 42 42 42 42 42 42 42 42 42 42 42 42 42 42 42 42 42 42 42 42 42 42 42 42 42
42 42 42 42 42 42 42 42 42 42 42 42 42 42 42 42 42 42 42 42 42 42 42 42 42 42 42 42 42 42 42 42 42 42 42 42 42 42 42 42 42 42 42 42 42 42 42 42 42 42
42 42 42 42 42 42 42 42 42 42 42 42 42 42 42 42 42 42 42 42 42 42 42 42 42 42 42 42 42 42 42 42 42 42 42 42 42 42 42 42 42 42 42 42 42 42 42 42 42 42
42 42 42 42 42 42 42 42 42 42 42 42 42 42 42 42 42 42 42 42 42 42 42 42 42 42 42 42 42 42 42 42 42 42 42 42 42 42 42 42 42 42 42 42 42 42 42 42 42 42
42 42 42 42 42 42 42 42 42 42 42 42 42 42 42 42 42 42 42 42 42 42 42 42 42 42 42 42 42 42 42 42 42 42 42 42 42 42 42 42 42 42 42 42 42 42 42 42 42 42
42 42 42 42 42 42 42 42 42 42 42 42 42 42 42 42 42 42 42 42 42 42 42 42 42 42 42 42 42 42 42 42 42 42 42 42 42 42 42 42 42 42 42 42 42 42 42 42 42 42
42 42 42 42 42 42 42 42 42 42 42 42 42 42 42 42 42 42 42 42 42 42 42 42 42 42 42 42 42 42 42 42 42 42 42 42 42 42 42 42 42 42 42 42 42 42 42 42 42 42
42 42 42 42 42 42 42 42 42 42 42 42 42 42 42 42 42 42 42 42 42 42 42 42 42 42 42 42 42 42 42 42 42 42 42 42 42 42 42 42 42 42 42 42 42 42 42 42 42 42
42 42 42 42 42 42 42 42 42 42 42 42 42 42 42 42 42 42 42 42 42 42 42 42 42 42 42 42 42 42 42 42 42 42 42 42 42 42 42 42 42 42 42 42 42 42 42 42 42 42