42 42 42 42 42 42 42 42 42 42 42 42 42 42 42 42 42 42 42 42 42 42 42 42 42 42 42 42 42 42 42 42 42 42 42 42 42 42 42 42 42 42 42 42 42 42 42 42 42 42
42 42 42 42 42 42 42 42 42 42 42 42 42 42 42 42 42 42 42 42 42 42 42 42 42 42 42 42 42 42 42 42 42 42 42 42 42 42 42 42 42 42 42 42 42 42 42 42 42 42
42 42 42 42 42 42 42 42 42 42 42 42 42 42 42 42 42 42 42 42 42 42 42 42 42 42 42 42 42 42 42 42 42 42 42 42 42 42 42 42 42 42 42 42 42 42 42 42 42 42
42 42 42 42 42 42 42 42 42 42 42 42 42 42 42 42 42 42 42 42 42 42 42 42 42 42 42 42 42 42 42 42 42 42 42 42 42 42 42 42 42 42 42 42 42 42 42 42 42 42
42 42 42 42 42 42 42 42 42 42 42 42 42 42 42 42 42 42 42 42 42 42 42 42 42 42 42 42 42 42 42 42 42 42 42 42 42 42 42 42 42 42 42 42 42 42 42 42 42 42
42 42 42 42 42 42 42 42 42 42 42 42 42 42 42 42 42 42 42 42 42 42 42 42 42 42 42 42 42 42 42 42 42 42 42 42 42 42 42 42 42 42 42 42 42 42 42 42 42 42
42 42 42 42 42 42 42 42 42 42 42 42 42 42 42 42 42 42 42 42 42 42 42 42 42 42 42 42 42 42 42 42 42 42 42 42 42 42 42 42 42 42 42 42 42 42 42 42 42 42
42 42 42 42 42 42 42 42 42 42 42 42 42 42 42 42 42 42 42 42 42 42 42 42 42 42 42 42 42 42 42 42 42 42 42 42 42 42 42 42 42 42 42 42 42 42 42 42 42 42
42 42 42 42 42 42 42 42 42 42 42 42 42 42 42 42 42 42 42 42 42 42 42 42 42 42 42 42 42 42 42 42 42 42 42 42 42 42 42 42 42 42 42 42 42 42 42 42 42 42
42 42 42 42 42 42 42 42 42 42 42 42 42 42 42 42 42 42 42 42 42 42 42 42 42 42 42 42 42 42 42 42 42 42 42 42 42 42 42 42 42 42 42 42 42 42 42 42 42 42
42 42 42 42 42 42 42 42 42 42 43 43 43 43 43 43 43 43 43 43 43 43 43 43 43 43 43 43 43 43 43 43 43 43 43 43 43 43 43 43 42 42 42 42 42 42 42 42 42 42
42 42 42 42 42 42 42 42 42 42 43 47 47 47 47 47 47 47 47 47 47 43 44 44 44 44 44 44 43 47 47 47 47 47 47 47 47 47 47 43 42 42 42 42 42 42 42 42 42 42
42 42 42 42 42 42 42 42 42 42 43 47 47 47 47 47 47 47 47 47 47 43 44 44 44 44 44 44 43 47 47 47 47 47 47 47 47 47 47 43 42 42 42 42 42 42 42 42 42 42
42 42 42 42 42 42 42 42 42 42 43 47 47 47 47 47 47 47 47 47 47 43 44 44 44 44 44 44 43 47 47 47 47 47 47 47 47 47 47 43 42 42 42 42 42 42 42 42 42 42
42 42 42 42 42 42 42 42 42 42 43 47 47 47 47 47 47 47 47 47 47 43 44 44 44 44 44 44 43 47 47 47 47 47 47 47 47 47 47 43 42 42 42 42 42 42 42 42 42 42
42 42 42 42 42 42 42 42 42 42 43 47 47 47 47 47 47 47 47 47 47 43 44 44 44 44 44 44 43 47 47 47 47 47 47 47 47 47 47 43 42 42 42 42 42 42 42 42 42 42
42 42 42 42 42 42 42 42 42 42 43 47 47 47 47 47 47 47 47 47 47 43 44 44 44 44 44 44 43 47 47 47 47 47 47 47 47 47 47 43 42 42 42 42 42 42 42 42 42 42
42 42 42 42 42 42 42 42 42 42 43 47 47 47 47 47 47 47 47 47 47 43 44 44 44 44 44 44 43 47 47 47 47 47 47 47 47 47 47 43 42 42 42 42 42 42 42 42 42 42
42 42 42 42 42 42 42 42 42 42 43 47 47 47 47 47 47 47 47 47 47 43 44 44 44 44 44 44 43 47 47 47 47 47 47 47 47 47 47 43 42 42 42 42 42 42 42 42 42 42
42 42 42 42 42 42 42 42 42 42 43 47 47 47 47 47 47 47 47 47 47 43 44 44 44 44 44 44 43 47 47 47 47 47 47 47 47 47 47 43 42 42 42 42 42 42 42 42 42 42
42 42 42 42 42 42 42 42 42 42 43 47 47 47 47 47 47 47 47 47 47 43 44 44 44 44 44 44 43 47 47 47 47 47 47 47 47 47 47 43 42 42 42 42 42 42 42 42 42 42
42 42 42 42 42 42 42 42 42 42 43 47 47 47 47 47 47 47 47 47 47 43 44 44 44 44 44 44 43 47 47 47 47 47 47 47 47 47 47 43 42 42 42 42 42 42 42 42 42 42
42 42 42 42 42 42 42 42 42 42 43 47 47 47 47 47 47 47 47 47 47 43 44 44 44 44 44 44 43 47 47 47 47 47 47 47 47 47 47 43 42 42 42 42 42 42 42 42 42 42
42 42 42 42 42 42 42 42 42 42 43 47 47 47 47 47 47 47 47 47 47 43 44 44 44 44 44 44 43 47 47 47 47 47 47 47 47 47 47 43 42 42 42 42 42 42 42 42 42 42
42 42 42 42 42 42 42 42 42 42 43 47 47 47 47 47 47 47 47 47 47 43 44 44 44 44 44 44 43 47 47 47 47 47 47 47 47 47 47 43 42 42 42 42 42 42 42 42 42 42
42 42 42 42 42 42 42 42 42 42 43 47 47 47 47 47 47 47 47 47 47 43 44 44 44 44 44 44 43 47 47 47 47 47 47 47 47 47 47 43 42 42 42 42 42 42 42 42 42 42
42 42 42 42 42 42 42 42 42 42 43 47 47 47 47 47 47 47 47 47 47 43 44 44 44 44 44 44 43 47 47 47 47 47 47 47 47 47 47 43 42 42 42 42 42 42 42 42 42 42
42 42 42 42 42 42 42 42 42 42 43 47 47 47 47 47 47 47 47 47 47 43 44 44 44 44 44 44 43 47 47 47 47 47 47 47 47 47 47 43 42 42 42 42 42 42 42 42 42 42
42 42 42 42 42 42 42 42 42 42 43 47 47 47 47 47 47 47 47 47 47 43 44 44 44 44 44 44 43 47 47 47 47 47 47 47 47 47 47 43 42 42 42 42 42 42 42 42 42 42
42 42 42 42 42 42 42 42 42 42 43 47 47 47 47 47 47 47 47 47 47 43 44 44 44 44 44 44 43 47 47 47 47 47 47 47 47 47 47 43 42 42 42 42 42 42 42 42 42 42
42 42 42 42 42 42 42 42 42 42 43 47 47 47 47 47 47 47 47 47 47 43 44 44 44 44 44 44 43 47 47 47 47 47 47 47 47 47 47 43 42 42 42 42 42 42 42 42 42 42
42 42 42 42 42 42 42 42 42 42 43 47 47 47 47 47 47 47 47 47 47 43 44 44 44 44 44 44 43 47 47 47 47 47 47 47 47 47 47 43 42 42 42 42 42 42 42 42 42 42
42 42 42 42 42 42 42 42 42 42 43 47 47 47 47 47 47 47 47 47 47 43 44 44 44 44 44 44 43 47 47 47 47 47 47 47 47 47 47 43 42 42 42 42 42 42 42 42 42 42
42 42 42 42 42 42 42 42 42 42 43 47 47 47 47 47 47 47 47 47 47 43 44 44 44 44 44 44 43 47 47 47 47 47 47 47 47 47 47 43 42 42 42 42 42 42 42 42 42 42
42 42 42 42 42 42 42 42 42 42 43 47 47 47 47 47 47 47 47 47 47 43 44 44 44 44 44 44 43 47 47 47 47 47 47 47 47 47 47 43 42 42 42 42 42 42 42 42 42 42
42 42 42 42 42 42 42 42 42 42 43 47 47 47 47 47 47 47 47 47 47 43 44 44 44 44 44 44 43 47 47 47 47 47 47 47 47 47 47 43 42 42 42 42 42 42 42 42 42 42
42 42 42 42 42 42 42 42 42 42 43 47 47 47 47 47 47 47 47 47 47 43 44 44 44 44 44 44 43 47 47 47 47 47 47 47 47 47 47 43 42 42 42 42 42 42 42 42 42 42
42 42 42 42 42 42 42 42 42 42 43 47 47 47 47 47 47 47 47 47 47 43 44 44 44 44 44 44 43 47 47 47 47 47 47 47 47 47 47 43 42 42 42 42 42 42 42 42 42 42
42 42 42 42 42 42 42 42 42 42 43 43 43 43 43 43 43 43 43 43 43 43 43 43 43 43 43 43 43 43 43 43 43 43 43 43 43 43 43 43 42 42 42 42 42 42 42 42 42 42
42 42 42 42 42 42 42 42 42 42 42 42 42 42 42 42 42 42 42 42 42 42 42 42 42 42 42 42 42 42 42 42 42 42 42 42 42 42 42 42 42 42 42 42 42 42 42 42 42 42
42 42 42 42 42 42 42 42 42 42 42 42 42 42 42 42 42 42 42 42 42 42 42 42 42 42 42 42 42 42 42 42 42 42 42 42 42 42 42 42 42 42 42 42 42 42 42 42 42 42
42 42 42 42 42 42 42 42 42 42 42 42 42 42 42 42 42 42 42 42 42 42 42 42 42 42 42 42 42 42 42 42 42 42 42 42 42 42 42 42 42 42 42 42 42 42 42 42 42 42
42 42 42 42 42 42 42 42 42 42 42 42 42 42 42 42 42 42 42 42 42 42 42 42 42 42 42 42 42 42 42 42 42 42 42 42 42 42 42 42 42 42 42 42 42 42 42 42 42 42
42 42 42 42 42 42 42 42 42 42 42 42 42 42 42 42 42 42 42 42 42 42 42 42 42 42 42 42 42 42 42 42 42 42 42 42 42 42 42 42 42 42 42 42 42 42 42 42 42 42
42 42 42 42 42 42 42 42 42 42 42 42 42 42 42 42 42 42 42 42 42 42 42 42 42 42 42 42 42 42 42 42 42 42 42 42 42 42 42 42 42 42 42 42 42 42 42 42 42 42
42 42 42 42 42 42 42 42 42 42 42 42 42 42 42 42 42 42 42 42 42 42 42 42 42 42 42 42 42 42 42 42 42 42 42 42 42 42 42 42 42 42 42 42 42 42 42 42 42 42
42 42 42 42 42 42 42 42 42 42 42 42 42 42 42 42 42 42 42 42 42 42 42 42 42 42 42 42 42 42 42 42 42 42 42 42 42 42 42 42 42 42 42 42 42 42 42 42 42 42
42 42 42 42 42 42 42 42 42 42 42 42 42 42 42 42 42 42 42 42 42 42 42 42 42 42 42 42 42 42 42 42 42 42 42 42 42 42 42 42 42 42 42 42 42 42 42 42 42 42
42 42 42 42 42 42 42 42 42 42 42 42 42 42 42 42 42 42 42 42 42 42 42 42 42 42 42 42 42 42 42 42 42 42 42 42 42 42 42 42 42 42 42 42 42 42 42 42 42 42
42 42 42 42 42 42 42 42 42 42 42 42 42 42 42 42 42 42 42 42 42 42 42 42 42 42 42 42 42 42 42 42 42 42 42 42 42 42 42 42 42 42 42 42 42 42 42 42 42 42