42 42 42 42 42 42 42 42 42 42 42 42 42 42 42 42 42 42 42 42 42 42 42 42 42 42 42 42 42 42 42 42 42 42 42 42 42 42 42 42 42 42 42 42 42 42 42 42 42 42 
42 42 42 42 42 42 42 42 42 42 42 42 42 42 42 42 42 42 42 42 42 42 42 42 42 42 42 42 42 42 42 42 42 42 42 42 42 42 42 42 42 42 42 42 42 42 42 42 42 42
42 42 42 42 42 42 42 42 42 42 42 42 42 42 42 42 42 42 42 42 42 42 42 42 42 42 42 42 42 42 42 42 42 42 42 42 42 42 42 42 42 42 42 42 42 42 42 42 42 42
42 42 42 42 42 42 42 42 42 42 42 42 42 42 42 42 42 42 42 42 42 42 42 42 42 42 42 42 42 42 42 42 42 42 42 42 42 42 42 42 42 42 42 42 42 42 42 42 42 42
42 42 42 42 42 42 42 42 42 42 42 42 42 42 42 42 42 42 42 42 42 42 42 42 42 42 42 42 42 42 42 42 42 42 42 42 42 42 42 42 42 42 42 42 42 42 42 42 42 42
42 42 42 42 42 42 42 42 42 42 42 42 42 42 42 42 42 42 42 42 42 42 42 42 42 42 42 42 42 42 42 42 42 42 42 42 42 42 42 42 42 42 42 42 42 42 42 42 42 42
42 42 42 42 42 42 42 42 42 42 42 42 42 42 42 42 42 42 42 42 42 42 42 42 42 42 42 42 42 42 42 42 42 42 42 42 42 42 42 42 42 42 42 42 42 42 42 42 42 42
42 42 42 42 42 42 42 42 42 42 42 42 42 42 42 42 42 42 42 42 42 42 42 42 42 42 42 42 42 42 42 42 42 42 42 42 42 42 42 42 42 42 42 42 42 42 42 42 42 42
42 42 42 42 42 42 42 42 42 42 42 42 42 42 42 42 42 42 42 42 42 42 42 42 42 42 42 42 42 42 42 42 42 42 42 42 42 42 42 42 42 42 42 42 42 42 42 42 42 42
42 42 42 42 42 42 42 42 42 42 98 98 98 98 98 98 98 98 98 98 98 98 98 98 98 98 98 98 98 98 98 98 98 98 98 98 98 98 98 98 42 42 42 42 42 42 42 42 42 42
42 42 42 42 42 42 42 42 42 42 98 77 99 99 99 99 98 99 99 99 99 99 98 106 106 106 106 106 98 102 99 99 102 99 98 104 104 104 104 98 42 42 42 42 42 42 42 42 42 42
42 42 42 42 42 42 42 42 42 42 98 99 99 99 99 99 98 99 99 99 99 99 98 106 106 106 106 106 98 99 99 99 99 99 98 106 106 106 106 98 42 42 42 42 42 42 42 42 42 42
42 42 42 42 42 42 42 42 42 42 98 99 99 99 99 99 100 99 99 99 99 99 100 106 106 102 106 106 100 99 99 102 99 99 100 104 104 104 104 100 42 42 42 42 42 42 42 42 42 42
42 42 42 42 42 42 42 42 42 42 98 99 99 99 99 99 98 99 99 99 99 99 98 106 106 106 106 106 98 99 99 99 99 99 98 106 106 106 106 98 42 42 42 42 42 42 42 42 42 42
42 42 42 42 42 42 42 42 42 42 98 99 99 99 99 99 98 99 99 99 99 99 98 106 106 106 106 106 98 102 99 102 99 102 98 99 99 99 99 98 42 42 42 42 42 42 42 42 42 42
42 42 42 42 42 42 42 42 42 42 98 98 98 101 98 98 98 98 98 101 98 98 98 98 98 101 98 98 98 98 98 101 98 98 98 98 98 101 98 98 42 42 42 42 42 42 42 42 42 42
42 42 42 42 42 42 42 42 42 42 98 104 104 104 104 104 98 106 106 106 106 106 98 99 99 99 99 99 98 99 99 99 99 99 98 104 104 104 104 98 42 42 42 42 42 42 42 42 42 42
42 42 42 42 42 42 42 42 42 42 98 104 106 102 106 104 98 106 102 102 102 106 98 99 102 102 102 99 98 99 99 99 99 99 98 104 104 104 104 98 42 42 42 42 42 42 42 42 42 42
42 42 42 42 42 42 42 42 42 42 100 104 102 102 102 104 100 106 102 103 102 106 100 99 102 103 102 99 100 99 99 99 99 99 100 104 104 104 104 100 42 42 42 42 42 42 42 42 42 42
42 42 42 42 42 42 42 42 42 42 98 104 106 102 106 104 98 106 102 102 102 106 98 99 102 102 102 99 98 99 99 99 99 99 98 104 104 104 104 98 42 42 42 42 42 42 42 42 42 42
42 42 42 42 42 42 42 42 42 42 98 104 104 104 104 104 98 106 106 106 106 106 98 99 99 99 99 99 98 99 99 99 99 99 98 104 104 104 104 98 42 42 42 42 42 42 42 42 42 42
42 42 42 42 42 42 42 42 42 42 98 98 98 101 98 98 98 98 98 101 98 98 98 98 98 101 98 98 98 98 98 101 98 98 98 98 98 101 98 98 42 42 42 42 42 42 42 42 42 42
42 42 42 42 42 42 42 42 42 42 98 104 104 104 104 104 98 99 99 99 99 99 98 99 99 99 99 99 98 104 104 104 104 104 98 99 99 99 99 98 42 42 42 42 42 42 42 42 42 42
42 42 42 42 42 42 42 42 42 42 98 104 104 104 104 104 98 99 99 102 99 99 98 99 99 99 99 99 98 104 106 106 106 104 98 99 99 99 99 98 42 42 42 42 42 42 42 42 42 42
42 42 42 42 42 42 42 42 42 42 100 104 104 104 104 104 100 99 102 102 102 99 100 99 99 99 99 99 100 104 106 106 106 104 100 99 99 99 99 100 42 42 42 42 42 42 42 42 42 42
42 42 42 42 42 42 42 42 42 42 98 104 104 104 104 104 98 99 99 102 99 99 98 99 99 99 99 99 98 104 106 106 106 104 98 99 99 99 99 98 42 42 42 42 42 42 42 42 42 42
42 42 42 42 42 42 42 42 42 42 98 104 104 104 104 104 98 99 99 99 99 99 98 99 99 99 99 99 98 104 104 104 104 104 98 99 99 99 99 98 42 42 42 42 42 42 42 42 42 42
42 42 42 42 42 42 42 42 42 42 98 98 98 101 98 98 98 98 98 101 98 98 98 98 98 101 98 98 98 98 98 101 98 98 98 98 98 101 98 98 42 42 42 42 42 42 42 42 42 42
42 42 42 42 42 42 42 42 42 42 98 99 99 99 99 99 98 106 106 106 106 106 98 106 106 106 106 106 98 99 99 99 99 99 98 102 99 99 102 98 42 42 42 42 42 42 42 42 42 42
42 42 42 42 42 42 42 42 42 42 98 99 99 99 99 99 98 106 104 104 104 106 98 106 106 106 106 106 98 99 102 102 102 99 98 99 99 99 99 98 42 42 42 42 42 42 42 42 42 42
42 42 42 42 42 42 42 42 42 42 100 99 99 99 99 99 100 106 104 104 104 106 100 106 106 106 106 106 100 99 102 103 102 99 100 99 99 99 99 100 42 42 42 42 42 42 42 42 42 42
42 42 42 42 42 42 42 42 42 42 98 99 99 99 99 99 98 106 104 104 104 106 98 106 106 106 106 106 98 99 102 102 102 99 98 102 99 99 102 98 42 42 42 42 42 42 42 42 42 42
42 42 42 42 42 42 42 42 42 42 98 99 99 99 99 99 98 106 106 106 106 106 98 106 106 106 106 106 98 99 99 99 99 99 98 102 99 99 102 98 42 42 42 42 42 42 42 42 42 42
42 42 42 42 42 42 42 42 42 42 98 98 98 101 98 98 98 98 98 101 98 98 98 98 98 101 98 98 98 98 98 101 98 98 98 98 98 101 98 98 42 42 42 42 42 42 42 42 42 42
42 42 42 42 42 42 42 42 42 42 98 99 99 99 99 99 98 99 99 99 99 99 98 99 99 99 99 99 98 104 104 104 104 104 98 99 99 99 99 98 42 42 42 42 42 42 42 42 42 42
42 42 42 42 42 42 42 42 42 42 98 99 102 102 99 99 98 99 99 99 99 99 98 99 99 99 99 99 98 104 104 104 104 104 98 99 99 99 99 98 42 42 42 42 42 42 42 42 42 42
42 42 42 42 42 42 42 42 42 42 100 99 102 102 99 99 100 99 99 99 99 99 100 99 99 99 99 99 100 104 104 104 104 104 100 99 99 99 99 100 42 42 42 42 42 42 42 42 42 42
42 42 42 42 42 42 42 42 42 42 98 99 99 99 99 99 98 99 99 99 99 99 98 99 99 99 99 99 98 104 104 104 104 104 98 99 99 99 105 98 42 42 42 42 42 42 42 42 42 42
42 42 42 42 42 42 42 42 42 42 98 98 98 101 98 98 98 98 98 101 98 98 98 98 98 101 98 98 98 98 98 101 98 98 98 98 98 101 98 98 42 42 42 42 42 42 42 42 42 42
42 42 42 42 42 42 42 42 42 42 42 42 42 42 42 42 42 42 42 42 42 42 42 42 42 42 42 42 42 42 42 42 42 42 42 42 42 42 42 42 42 42 42 42 42 42 42 42 42 42
42 42 42 42 42 42 42 42 42 42 42 42 42 42 42 42 42 42 42 42 42 42 42 42 42 42 42 42 42 42 42 42 42 42 42 42 42 42 42 42 42 42 42 42 42 42 42 42 42 42
42 42 42 42 42 42 42 42 42 42 42 42 42 42 42 42 42 42 42 42 42 42 42 42 42 42 42 42 42 42 42 42 42 42 42 42 42 42 42 42 42 42 42 42 42 42 42 42 42 42
42 42 42 42 42 42 42 42 42 42 42 42 42 42 42 42 42 42 42 42 42 42 42 42 42 42 42 42 42 42 42 42 42 42 42 42 42 42 42 42 42 42 42 42 42 42 42 42 42 42
42 42 42 42 42 42 42 42 42 42 42 42 42 42 42 42 42 42 42 42 42 42 42 42 42 42 42 42 42 42 42 42 42 42 42 42 42 42 42 42 42 42 42 42 42 42 42 42 42 42
42 42 42 42 42 42 42 42 42 42 42 42 42 42 42 42 42 42 42 42 42 42 42 42 42 42 42 42 42 42 42 42 42 42 42 42 42 42 42 42 42 42 42 42 42 42 42 42 42 42
42 42 42 42 42 42 42 42 42 42 42 42 42 42 42 42 42 42 42 42 42 42 42 42 42 42 42 42 42 42 42 42 42 42 42 42 42 42 42 42 42 42 42 42 42 42 42 42 42 42
42 42 42 42 42 42 42 42 42 42 42 42 42 42 42 42 42 42 42 42 42 42 42 42 42 42 42 42 42 42 42 42 42 42 42 42 42 42 42 42 42 42 42 42 42 42 42 42 42 42
42 42 42 42 42 42 42 42 42 42 42 42 42 42 42 42 42 42 42 42 42 42 42 42 42 42 42 42 42 42 42 42 42 42 42 42 42 42 42 42 42 42 42 42 42 42 42 42 42 42
42 42 42 42 42 42 42 42 42 42 42 42 42 42 42 42 42 42 42 42 42 42 42 42 42 42 42 42 42 42 42 42 42 42 42 42 42 42 42 42 42 42 42 42 42 42 42 42 42 42
42 42 42 42 42 42 42 42 42 42 42 42 42 42 42 42 42 42 42 42 42 42 42 42 42 42 42 42 42 42 42 42 42 42 42 42 42 42 42 42 42 42 42 42 42 42 42 42 42 42