114 114 114 114 114 114 114 114 114 114 114 114 114 114 114 114 114 114 114 114 114 114 114 114 114 114 114 114 114 114 114 114 114 114 114 114 114 114 114 114 114 114 114 114 114 114 114 114 114 0
114 114 114 114 114 114 114 114 114 114 114 114 114 114 114 114 114 114 114 114 114 114 114 114 114 114 114 114 114 114 114 114 114 114 114 114 114 114 114 114 114 114 114 114 114 114 114 114 114 0
114 114 114 114 114 114 114 114 114 114 114 114 114 114 114 114 114 114 114 114 114 114 114 114 114 114 114 114 114 114 114 114 114 114 114 114 114 114 114 114 114 114 114 114 114 114 114 114 114 0
114 114 114 114 114 114 114 114 114 114 114 114 114 114 114 114 114 114 114 114 114 114 114 114 114 114 114 114 114 114 114 114 114 114 114 114 114 114 114 114 114 114 114 114 114 114 114 114 114 0
114 114 114 114 114 114 114 114 114 114 114 114 114 114 114 114 114 114 114 114 114 114 114 114 114 114 114 114 114 114 114 114 114 114 114 114 114 114 114 114 114 114 114 114 114 114 114 114 114 0
114 114 114 114 114 114 114 114 114 114 114 114 114 114 114 114 114 114 114 114 114 114 114 114 114 114 114 114 114 114 114 114 114 114 114 114 114 114 114 114 114 114 114 114 114 114 114 114 114 0
114 114 114 114 114 114 114 114 114 114 114 114 114 114 114 114 114 114 114 114 114 114 114 114 114 114 114 114 114 114 114 114 114 114 114 114 114 114 114 114 114 114 114 114 114 114 114 114 114 0
114 114 114 114 114 114 114 114 114 114 114 114 114 114 114 114 114 114 114 114 114 114 114 114 114 114 114 114 114 114 114 114 114 114 114 114 114 114 114 114 114 114 114 114 114 114 114 114 114 0
114 114 114 114 114 114 114 114 114 114 114 114 114 114 114 114 114 114 114 114 114 114 114 114 114 114 114 114 114 114 114 114 114 114 114 114 114 114 114 114 114 114 114 114 114 114 114 114 114 0
114 114 114 114 114 114 114 114 114 114 114 114 114 113 113 113 113 113 113 113 113 113 113 113 113 113 113 113 113 113 113 113 113 113 113 113 114 114 114 114 114 114 114 114 114 114 114 114 114 0
114 114 114 114 114 114 114 114 114 114 114 114 114 113 108 108 108 108 108 108 108 108 108 108 112 108 108 108 108 108 108 108 108 108 108 113 114 114 114 114 114 114 114 114 114 114 114 114 114 0
114 114 114 114 114 114 114 114 114 114 114 114 114 113 108 107 107 107 107 107 107 107 107 107 107 107 107 107 107 107 107 107 107 107 108 113 114 114 114 114 114 114 114 114 114 114 114 114 114 0
114 114 114 114 114 114 114 114 114 114 114 114 114 113 108 107 107 107 107 107 107 107 107 107 107 107 107 107 107 107 107 107 107 107 108 113 114 114 114 114 114 114 114 114 114 114 114 114 114 0
114 114 114 114 114 114 114 114 114 114 114 114 114 113 108 107 107 107 107 107 107 107 107 111 111 111 107 107 107 107 107 107 107 107 108 113 114 114 114 114 114 114 114 114 114 114 114 114 114 0
114 114 114 114 114 114 114 114 114 114 114 114 114 113 108 107 107 107 107 107 107 111 111 111 111 111 111 111 107 107 107 107 107 107 108 113 114 114 114 114 114 114 114 114 114 114 114 114 114 0
114 114 114 114 114 114 114 114 114 114 114 114 114 113 108 107 107 107 107 107 107 111 111 111 111 111 111 111 107 107 107 107 107 107 108 113 114 114 114 114 114 114 114 114 114 114 114 114 114 0
114 114 114 114 114 114 114 114 114 114 114 114 114 113 108 107 107 107 107 107 111 111 111 111 111 111 111 111 111 107 107 107 107 107 108 113 114 114 114 114 114 114 114 114 114 114 114 114 114 0
114 114 114 114 114 114 114 114 114 114 114 114 114 113 108 107 107 107 107 107 111 111 111 108 108 108 111 111 111 107 107 107 107 107 108 113 114 114 114 114 114 114 114 114 114 114 114 114 114 0
114 114 114 114 114 114 114 114 114 114 114 114 114 113 108 107 107 107 107 107 108 108 108 108 108 108 108 108 108 107 107 107 107 107 108 113 114 114 114 114 114 114 114 114 114 114 114 114 114 0
114 114 114 114 114 114 114 114 114 114 114 114 114 113 108 107 107 107 107 107 108 108 108 108 108 108 108 108 108 107 107 107 107 107 108 113 114 114 114 114 114 114 114 114 114 114 114 114 114 0
114 114 114 114 114 114 114 114 114 114 114 114 114 113 108 107 107 107 107 107 107 108 108 108 108 108 108 108 107 107 107 107 107 107 108 113 114 114 114 114 114 114 114 114 114 114 114 114 114 0
114 114 114 114 114 114 114 114 114 114 114 114 114 113 108 107 107 107 107 107 107 107 107 108 108 108 107 107 107 107 107 107 107 107 108 113 114 114 114 114 114 114 114 114 114 114 114 114 114 0
114 114 114 114 114 114 114 114 114 114 114 114 114 113 108 107 107 107 107 107 107 107 107 107 107 107 107 107 107 107 107 107 107 107 108 113 114 114 114 114 114 114 114 114 114 114 114 114 114 0
114 114 114 114 114 114 114 114 114 114 114 114 114 113 108 107 107 107 107 107 107 107 107 107 107 107 107 107 107 107 107 107 107 107 108 113 114 114 114 114 114 114 114 114 114 114 114 114 114 0
114 114 114 114 114 114 114 114 114 114 114 114 114 113 108 108 108 108 108 108 108 108 108 108 75 108 108 108 108 108 108 108 108 108 108 113 114 114 114 114 114 114 114 114 114 114 114 114 114 0
114 114 114 114 114 114 114 114 114 114 114 114 114 113 113 113 113 113 113 113 113 113 113 113 113 113 113 113 113 113 113 113 113 113 113 113 114 114 114 114 114 114 114 114 114 114 114 114 114 0
114 114 114 114 114 114 114 114 114 114 114 114 114 114 114 114 114 114 114 114 114 114 114 114 114 114 114 114 114 114 114 114 114 114 114 114 114 114 114 114 114 114 114 114 114 114 114 114 114 0
114 114 114 114 114 114 114 114 114 114 114 114 114 114 114 114 114 114 114 114 114 114 114 114 114 114 114 114 114 114 114 114 114 114 114 114 114 114 114 114 114 114 114 114 114 114 114 114 114 0
114 114 114 114 114 114 114 114 114 114 114 114 114 114 114 114 114 114 114 114 114 114 114 114 114 114 114 114 114 114 114 114 114 114 114 114 114 114 114 114 114 114 114 114 114 114 114 114 114 0
114 114 114 114 114 114 114 114 114 114 114 114 114 114 114 114 114 114 114 114 114 114 114 114 114 114 114 114 114 114 114 114 114 114 114 114 114 114 114 114 114 114 114 114 114 114 114 114 114 0
114 114 114 114 114 114 114 114 114 114 114 114 114 114 114 114 114 114 114 114 114 114 114 114 114 114 114 114 114 114 114 114 114 114 114 114 114 114 114 114 114 114 114 114 114 114 114 114 114 0
114 114 114 114 114 114 114 114 114 114 114 114 114 114 114 114 114 114 114 114 114 114 114 114 114 114 114 114 114 114 114 114 114 114 114 114 114 114 114 114 114 114 114 114 114 114 114 114 114 0
114 114 114 114 114 114 114 114 114 114 114 114 114 114 114 114 114 114 114 114 114 114 114 114 114 114 114 114 114 114 114 114 114 114 114 114 114 114 114 114 114 114 114 114 114 114 114 114 114 0
114 114 114 114 114 114 114 114 114 114 114 114 114 114 114 114 114 114 114 114 114 114 114 114 114 114 114 114 114 114 114 114 114 114 114 114 114 114 114 114 114 114 114 114 114 114 114 114 114 0
114 114 114 114 114 114 114 114 114 114 114 114 114 114 114 114 114 114 114 114 114 114 114 114 114 114 114 114 114 114 114 114 114 114 114 114 114 114 114 114 114 114 114 114 114 114 114 114 114 0
114 114 114 114 114 114 114 114 114 114 114 114 114 114 114 114 114 114 114 114 114 114 114 114 114 114 114 114 114 114 114 114 114 114 114 114 114 114 114 114 114 114 114 114 114 114 114 114 114 0
114 114 114 114 114 114 114 114 114 114 114 114 114 114 114 114 114 114 114 114 114 114 114 114 114 114 114 114 114 114 114 114 114 114 114 114 114 114 114 114 114 114 114 114 114 114 114 114 114 0
114 114 114 114 114 114 114 114 114 114 114 114 114 114 114 114 114 114 114 114 114 114 114 114 114 114 114 114 114 114 114 114 114 114 114 114 114 114 114 114 114 114 114 114 114 114 114 114 114 0
114 114 114 114 114 114 114 114 114 114 114 114 114 114 114 114 114 114 114 114 114 114 114 114 114 114 114 114 114 114 114 114 114 114 114 114 114 114 114 114 114 114 114 114 114 114 114 114 114 0
114 114 114 114 114 114 114 114 114 114 114 114 114 114 114 114 114 114 114 114 114 114 114 114 114 114 114 114 114 114 114 114 114 114 114 114 114 114 114 114 114 114 114 114 114 114 114 114 114 0
114 114 114 114 114 114 114 114 114 114 114 114 114 114 114 114 114 114 114 114 114 114 114 114 114 114 114 114 114 114 114 114 114 114 114 114 114 114 114 114 114 114 114 114 114 114 114 114 114 0
114 114 114 114 114 114 114 114 114 114 114 114 114 114 114 114 114 114 114 114 114 114 114 114 114 114 114 114 114 114 114 114 114 114 114 114 114 114 114 114 114 114 114 114 114 114 114 114 114 0
114 114 114 114 114 114 114 114 114 114 114 114 114 114 114 114 114 114 114 114 114 114 114 114 114 114 114 114 114 114 114 114 114 114 114 114 114 114 114 114 114 114 114 114 114 114 114 114 114 0
114 114 114 114 114 114 114 114 114 114 114 114 114 114 114 114 114 114 114 114 114 114 114 114 114 114 114 114 114 114 114 114 114 114 114 114 114 114 114 114 114 114 114 114 114 114 114 114 114 0
114 114 114 114 114 114 114 114 114 114 114 114 114 114 114 114 114 114 114 114 114 114 114 114 114 114 114 114 114 114 114 114 114 114 114 114 114 114 114 114 114 114 114 114 114 114 114 114 114 0
114 114 114 114 114 114 114 114 114 114 114 114 114 114 114 114 114 114 114 114 114 114 114 114 114 114 114 114 114 114 114 114 114 114 114 114 114 114 114 114 114 114 114 114 114 114 114 114 114 0
114 114 114 114 114 114 114 114 114 114 114 114 114 114 114 114 114 114 114 114 114 114 114 114 114 114 114 114 114 114 114 114 114 114 114 114 114 114 114 114 114 114 114 114 114 114 114 114 114 0
114 114 114 114 114 114 114 114 114 114 114 114 114 114 114 114 114 114 114 114 114 114 114 114 114 114 114 114 114 114 114 114 114 114 114 114 114 114 114 114 114 114 114 114 114 114 114 114 114 0
114 114 114 114 114 114 114 114 114 114 114 114 114 114 114 114 114 114 114 114 114 114 114 114 114 114 114 114 114 114 114 114 114 114 114 114 114 114 114 114 114 114 114 114 114 114 114 114 114 0
114 114 114 114 114 114 114 114 114 114 114 114 114 114 114 114 114 114 114 114 114 114 114 114 114 114 114 114 114 114 114 114 114 114 114 114 114 114 114 114 114 114 114 114 114 114 114 114 114 0