13 13 13 13 13 13 13 13 13 13 13 13 13 13 13 13 13 13 13 13 13 13 13 13 13 13 13 13 13 13 13 13 13 13 13 13 13 13 13 13 13 13 13 13 13 13 13 13 13 13
13 13 13 13 13 13 13 13 13 13 13 13 13 13 13 13 13 13 13 13 13 13 13 13 13 13 13 13 13 13 13 13 13 13 13 13 13 13 13 13 13 13 13 13 13 13 13 13 13 13
13 13 13 13 13 13 13 13 13 13 13 13 13 13 13 13 13 13 13 13 13 13 13 13 13 13 13 13 13 13 13 13 13 13 13 13 13 13 13 13 13 13 13 13 13 13 13 13 13 13
13 13 13 13 13 13 13 13 13 13 13 13 13 13 13 13 13 13 13 13 13 13 13 13 13 13 13 13 13 13 13 13 13 13 13 13 13 13 13 13 13 13 13 13 13 13 13 13 13 13
13 13 13 13 13 13 13 13 13 13 13 13 13 13 13 13 13 13 13 13 13 13 13 13 13 13 13 13 13 13 13 13 13 13 13 13 13 13 13 13 13 13 13 13 13 13 13 13 13 13
13 13 13 13 13 13 13 13 13 13 13 13 13 13 13 13 13 13 13 13 13 13 13 13 13 13 13 13 13 13 13 13 13 13 13 13 13 13 13 13 13 13 13 13 13 13 13 13 13 13
13 13 13 13 13 13 13 13 13 13 13 13 13 13 13 13 13 13 13 13 13 13 13 13 13 13 13 13 13 13 13 13 13 13 13 13 13 13 13 13 13 13 13 13 13 13 13 13 13 13
13 13 13 13 13 13 13 13 13 13 13 13 13 13 13 13 13 13 13 13 13 13 13 13 13 13 13 13 13 13 13 13 13 13 13 13 13 13 13 13 13 13 13 13 13 13 13 13 13 13
13 13 13 13 13 13 13 13 13 13 13 13 13 13 13 13 13 13 13 13 13 13 13 13 13 13 13 13 13 13 13 13 13 13 13 13 13 13 13 13 13 13 13 13 13 13 13 13 13 13
13 13 13 13 13 13 13 13 13 13 13 13 13 13 13 13 13 13 13 13 13 13 13 13 13 13 13 13 13 13 13 13 13 13 13 13 13 13 13 13 13 13 13 13 13 13 13 13 13 13
13 13 13 13 13 13 13 13 13 13 13 13 13 13 13 13 13 13 13 13 13 13 13 13 13 13 13 13 13 13 13 13 13 13 13 13 13 13 13 13 13 13 13 13 13 13 13 13 13 13
13 13 13 13 13 13 13 13 13 13 13 13 13 13 13 13 13 13 13 13 13 13 13 13 13 13 13 13 13 13 13 13 13 13 13 13 13 13 13 13 13 13 13 13 13 13 13 13 13 13
13 13 13 13 13 13 13 13 13 13 13 13 13 13 13 13 13 13 13 13 13 13 13 13 13 13 13 13 13 13 13 13 13 13 13 13 13 13 13 13 13 13 13 13 13 13 13 13 13 13
13 13 13 13 13 13 13 13 13 13 13 13 13 13 13 13 13 13 13 13 13 13 13 13 13 13 13 13 13 13 13 13 13 13 13 13 13 13 13 13 13 13 13 13 13 13 13 13 13 13
13 13 13 13 13 13 13 13 13 13 13 13 13 13 13 13 13 13 13 13 13 13 13 13 13 13 13 13 13 13 13 13 13 13 13 13 13 13 13 13 13 13 13 13 13 13 13 13 13 13
13 13 13 13 13 13 13 13 13 13 66 66 66 66 66 66 66 66 66 66 66 66 66 66 66 66 66 66 66 66 66 66 66 66 66 66 66 66 66 68 13 13 13 13 13 13 13 13 13 13
13 13 13 13 13 13 13 13 13 13 67 0 0 0 0 0 0 0 0 0 0 0 0 0 0 0 0 0 0 0 0 0 0 0 0 0 0 0 0 68 13 13 13 13 13 13 13 13 13 13
13 13 13 13 13 13 13 13 13 13 67 0 0 0 0 0 0 0 0 0 0 0 0 0 0 0 0 0 0 0 0 0 0 0 0 0 0 0 0 68 13 13 13 13 13 13 13 13 13 13
13 13 13 13 13 13 13 13 13 13 67 0 0 0 0 0 0 0 0 0 0 0 0 70 71 71 0 0 0 0 0 0 0 0 0 0 0 0 0 68 13 13 13 13 13 13 13 13 13 13
13 13 13 13 13 13 13 13 13 13 67 0 0 0 0 4 0 0 4 0 0 0 0 0 0 0 0 0 0 0 4 0 0 4 0 0 0 0 0 68 13 13 13 13 13 13 13 13 13 13
13 13 13 13 13 13 13 13 13 13 67 0 0 0 4 5 4 4 5 4 0 0 0 0 0 0 0 0 0 4 5 4 4 5 4 0 0 0 0 68 13 13 13 13 13 13 13 13 13 13
13 13 13 13 13 13 13 13 13 13 67 0 0 0 0 4 0 0 4 0 0 0 0 0 0 0 0 0 0 0 4 0 0 4 0 0 0 0 0 68 13 13 13 13 13 13 13 13 13 13
13 13 13 13 13 13 13 13 13 13 67 0 0 0 0 0 0 0 0 0 0 0 0 0 0 0 0 0 0 0 0 0 0 0 0 0 0 0 0 68 13 13 13 13 13 13 13 13 13 13
13 13 13 13 13 13 13 13 13 13 67 0 0 0 4 4 4 4 4 4 4 0 0 0 0 0 0 0 4 4 4 4 4 4 4 0 0 0 0 68 13 13 13 13 13 13 13 13 13 13
13 13 13 13 13 13 13 13 13 13 67 0 0 0 64 64 64 64 64 64 64 0 0 0 0 0 0 0 64 64 64 64 64 64 64 0 0 0 0 68 13 13 13 13 13 13 13 13 13 13
13 13 13 13 13 13 13 13 13 13 67 0 0 0 10 10 10 10 10 10 10 0 0 0 0 0 0 0 10 10 10 10 10 10 10 0 0 0 0 68 13 13 13 13 13 13 13 13 13 13
13 13 13 13 13 13 13 13 13 13 67 0 0 0 4 4 4 4 4 4 4 0 0 0 0 0 0 0 4 4 4 4 4 4 4 0 0 0 0 68 13 13 13 13 13 13 13 13 13 13
13 13 13 13 13 13 13 13 13 13 67 0 0 0 0 0 0 0 0 0 0 0 0 0 0 0 0 0 0 0 0 0 0 0 0 0 0 0 0 68 13 13 13 13 13 13 13 13 13 13
13 13 13 13 13 13 13 13 13 13 67 0 0 0 0 0 0 0 0 0 0 0 0 0 0 0 0 0 0 0 0 0 0 0 0 0 0 0 0 68 13 13 13 13 13 13 13 13 13 13
13 13 13 13 13 13 13 13 13 13 67 0 0 0 4 4 4 4 4 4 4 0 0 0 0 0 0 0 4 4 4 4 4 4 4 0 0 0 0 68 13 13 13 13 13 13 13 13 13 13
13 13 13 13 13 13 13 13 13 13 67 0 0 0 64 64 64 64 64 64 64 0 0 0 0 0 0 0 64 64 64 64 64 64 64 0 0 0 0 68 13 13 13 13 13 13 13 13 13 13
13 13 13 13 13 13 13 13 13 13 67 0 0 0 10 10 10 10 10 10 10 0 0 0 0 0 0 0 10 10 10 10 10 10 10 0 0 0 0 68 13 13 13 13 13 13 13 13 13 13
13 13 13 13 13 13 13 13 13 13 67 0 0 0 4 4 4 4 4 4 4 0 0 0 0 0 0 0 4 4 4 4 4 4 4 0 0 0 0 68 13 13 13 13 13 13 13 13 13 13
13 13 13 13 13 13 13 13 13 13 67 0 0 0 0 0 0 0 0 0 0 0 0 0 0 0 0 0 0 0 0 0 0 0 0 0 0 0 0 68 13 13 13 13 13 13 13 13 13 13
13 13 13 13 13 13 13 13 13 13 67 0 0 0 0 0 0 0 0 0 0 0 0 0 0 0 0 0 0 0 0 0 0 0 0 0 0 0 0 68 13 13 13 13 13 13 13 13 13 13
13 13 13 13 13 13 13 13 13 13 67 69 69 69 69 69 69 69 69 69 69 69 69 69 65 69 69 69 69 69 69 69 69 69 69 69 69 69 69 69 13 13 13 13 13 13 13 13 13 13 13 13 13 13 13 13 13 13 13
13 13 13 13 13 13 13 13 13 13 13 13 13 13 13 13 13 13 13 13 13 13 13 13 13 13 13 13 13 13 13 13 13 13 13 13 13 13 13 13 13 13 13 13 13 13 13 13 13 13
13 13 13 13 13 13 13 13 13 13 13 13 13 13 13 13 13 13 13 13 13 13 13 13 13 13 13 13 13 13 13 13 13 13 13 13 13 13 13 13 13 13 13 13 13 13 13 13 13 13
13 13 13 13 13 13 13 13 13 13 13 13 13 13 13 13 13 13 13 13 13 13 13 13 13 13 13 13 13 13 13 13 13 13 13 13 13 13 13 13 13 13 13 13 13 13 13 13 13 13
13 13 13 13 13 13 13 13 13 13 13 13 13 13 13 13 13 13 13 13 13 13 13 13 13 13 13 13 13 13 13 13 13 13 13 13 13 13 13 13 13 13 13 13 13 13 13 13 13 13
13 13 13 13 13 13 13 13 13 13 13 13 13 13 13 13 13 13 13 13 13 13 13 13 13 13 13 13 13 13 13 13 13 13 13 13 13 13 13 13 13 13 13 13 13 13 13 13 13 13
13 13 13 13 13 13 13 13 13 13 13 13 13 13 13 13 13 13 13 13 13 13 13 13 13 13 13 13 13 13 13 13 13 13 13 13 13 13 13 13 13 13 13 13 13 13 13 13 13 13
13 13 13 13 13 13 13 13 13 13 13 13 13 13 13 13 13 13 13 13 13 13 13 13 13 13 13 13 13 13 13 13 13 13 13 13 13 13 13 13 13 13 13 13 13 13 13 13 13 13
13 13 13 13 13 13 13 13 13 13 13 13 13 13 13 13 13 13 13 13 13 13 13 13 13 13 13 13 13 13 13 13 13 13 13 13 13 13 13 13 13 13 13 13 13 13 13 13 13 13
13 13 13 13 13 13 13 13 13 13 13 13 13 13 13 13 13 13 13 13 13 13 13 13 13 13 13 13 13 13 13 13 13 13 13 13 13 13 13 13 13 13 13 13 13 13 13 13 13 13
13 13 13 13 13 13 13 13 13 13 13 13 13 13 13 13 13 13 13 13 13 13 13 13 13 13 13 13 13 13 13 13 13 13 13 13 13 13 13 13 13 13 13 13 13 13 13 13 13 13
13 13 13 13 13 13 13 13 13 13 13 13 13 13 13 13 13 13 13 13 13 13 13 13 13 13 13 13 13 13 13 13 13 13 13 13 13 13 13 13 13 13 13 13 13 13 13 13 13 13
13 13 13 13 13 13 13 13 13 13 13 13 13 13 13 13 13 13 13 13 13 13 13 13 13 13 13 13 13 13 13 13 13 13 13 13 13 13 13 13 13 13 13 13 13 13 13 13 13 13
13 13 13 13 13 13 13 13 13 13 13 13 13 13 13 13 13 13 13 13 13 13 13 13 13 13 13 13 13 13 13 13 13 13 13 13 13 13 13 13 13 13 13 13 13 13 13 13 13 13
13 13 13 13 13 13 13 13 13 13 13 13 13 13 13 13 13 13 13 13 13 13 13 13 13 13 13 13 13 13 13 13 13 13 13 13 13 13 13 13 13 13 13 13 13 13 13 13 13 13